NO resources/assets/png/wall_1.png
SO resources/assets/png/wall_2.png
WE resources/assets/png/wall_3.png
EA resources/assets/png/wall_4.png



F 128, 81, 15
C 9, 120, 143

11111111111111111111111111111111111                    1111111
    11000000000001100000000000000001111111111        11111  11111111
      10000010000S0011100000000000010001110001111111111    11 11    11111111
       1100000110000000110000010001111111111111          111     1111   11
        10000000011100000000000010011              111        111    111
1111111111100000000011000001110111101    1111       11          111111
1111111000000111111111011100000010001111111       11011         111
110000001111011111111101110101001000000000011      1111         11
  1111100000000011010101110000000001111110001      11111111111111
       1100000000000000011000000100011111111011111111
        10000000000000001101010010001111111101111111
111111111100000011010101111101111000000000100001111111
11011100000011111111101111111010111100110000011
1111111111100111111111111111111111111000001111
         11111                      11011111
         11111          111         1111 
         11111         11            11
            11        11              1
1111111111111